__________________
__________________
__________________
____^___....._____
____.___.___._____
____.___.___._____
____.....___$_____
__________________
__________________
__________________
